NULL
0,0,0,0,0
0,0,0,0,0
0,0,0,0,0
0,0,0,0,0
0,0,0,0,0
0,0,0,0,0
0,0,0,0,0

Colors
[0x000000, 0x040404, 0x550055]
0,0,0,0,0
0,0,0,0,0
0,0,1,0,0
0,0,0,2,0
0,0,0,0,0
0,0,0,0,0
0,0,0,0,0

A
0,1,1,1,0
1,0,0,0,1
1,0,0,0,1
1,0,0,0,1
1,1,1,1,1
1,0,0,0,1
1,0,0,0,1

B
1,1,1,1,0
1,0,0,0,1
1,0,0,0,1
1,1,1,1,0
1,0,0,0,1
1,0,0,0,1
1,1,1,1,0

C
0,1,1,1,1
1,0,0,0,0
1,0,0,0,0
1,0,0,0,0
1,0,0,0,0
1,0,0,0,0
0,1,1,1,1

D
1,1,1,1,0
1,0,0,0,1
1,0,0,0,1
1,0,0,0,1
1,0,0,0,1
1,0,0,0,1
1,1,1,1,0

E
1,1,1,1,1
1,0,0,0,0
1,0,0,0,0
1,1,1,1,1
1,0,0,0,0
1,0,0,0,0
1,1,1,1,1

F
1,1,1,1,1
1,0,0,0,0
1,0,0,0,0
1,1,1,1,0
1,0,0,0,0
1,0,0,0,0
1,0,0,0,0

G
0,1,1,1,0
1,0,0,0,0
1,0,0,0,0
1,0,1,1,1
1,0,0,0,1
1,0,0,0,1
0,1,1,1,0

H
1,0,0,0,1
1,0,0,0,1
1,0,0,0,1
1,1,1,1,1
1,0,0,0,1
1,0,0,0,1
1,0,0,0,1

I
1,1,1,1,1
0,0,1,0,0
0,0,1,0,0
0,0,1,0,0
0,0,1,0,0
0,0,1,0,0
1,1,1,1,1

J
0,0,0,0,1
0,0,0,0,1
0,0,0,0,1
0,0,0,0,1
0,0,0,0,1
1,0,0,0,1
0,1,1,1,0

K
1,0,0,0,1
1,0,0,1,0
1,0,1,0,0
1,1,0,0,0
1,0,1,0,0
1,0,0,1,0
1,0,0,0,1

L
1,0,0,0,0
1,0,0,0,0
1,0,0,0,0
1,0,0,0,0
1,0,0,0,0
1,0,0,0,0
1,1,1,1,1

M
1,0,0,0,1
1,1,0,1,1
1,0,1,0,1
1,0,0,0,1
1,0,0,0,1
1,0,0,0,1
1,0,0,0,1

N
1,0,0,0,1
1,1,0,0,1
1,0,1,0,1
1,0,1,0,1
1,0,1,0,1
1,0,0,1,1
1,0,0,0,1

O
0,1,1,1,0
1,0,0,0,1
1,0,0,0,1
1,0,0,0,1
1,0,0,0,1
1,0,0,0,1
0,1,1,1,0

P
1,1,1,1,0
1,0,0,0,1
1,0,0,0,1
1,1,1,1,0
1,0,0,0,0
1,0,0,0,0
1,0,0,0,0

Q
0,1,1,1,0
1,0,0,0,1
1,0,0,0,1
1,0,0,0,1
1,0,1,0,1
1,0,0,1,0
0,1,1,0,1

R
1,1,1,1,0
1,0,0,0,1
1,0,0,0,1
1,1,1,1,0
1,0,1,0,0
1,0,0,1,0
1,0,0,0,1

S
0,1,1,1,1
1,0,0,0,0
1,0,0,0,0
0,1,1,1,0
0,0,0,0,1
0,0,0,0,1
1,1,1,1,0

T
1,1,1,1,1
0,0,1,0,0
0,0,1,0,0
0,0,1,0,0
0,0,1,0,0
0,0,1,0,0
0,0,1,0,0

U
1,0,0,0,1
1,0,0,0,1
1,0,0,0,1
1,0,0,0,1
1,0,0,0,1
1,0,0,0,1
0,1,1,1,0

V
1,0,0,0,1
1,0,0,0,1
1,0,0,0,1
1,0,0,0,1
0,1,0,1,0
0,1,0,1,0
0,0,1,0,0

W
1,0,0,0,1
1,0,0,0,1
1,0,0,0,1
1,0,0,0,1
1,0,1,0,1
1,1,0,1,1
1,0,0,0,1

X
1,0,0,0,1
0,1,0,1,0
0,1,0,1,0
0,0,1,0,0
0,1,0,1,0
0,1,0,1,0
1,0,0,0,1

Y
1,0,0,0,1
0,1,0,1,0
0,1,0,1,0
0,0,1,0,0
0,0,1,0,0
0,0,1,0,0
0,0,1,0,0

Z
1,1,1,1,1
0,0,0,0,1
0,0,0,1,0
0,0,1,0,0
0,1,0,0,0
1,0,0,0,0
1,1,1,1,1

n0
0,0,0,0,0
0,0,0,0,0
0,0,0,0,0
0,0,0,0,0
0,0,0,0,0
0,0,0,0,0
0,0,0,0,0

n1
0,0,0,0,0
0,0,0,0,0
0,0,0,0,0
0,0,0,0,0
0,0,0,0,0
0,0,0,0,0
0,0,0,0,0

n2
0,0,0,0,0
0,0,0,0,0
0,0,0,0,0
0,0,0,0,0
0,0,0,0,0
0,0,0,0,0
0,0,0,0,0

n3
0,0,0,0,0
0,0,0,0,0
0,0,0,0,0
0,0,0,0,0
0,0,0,0,0
0,0,0,0,0
0,0,0,0,0

n4
0,0,0,0,0
0,0,0,0,0
0,0,0,0,0
0,0,0,0,0
0,0,0,0,0
0,0,0,0,0
0,0,0,0,0

n5
0,0,0,0,0
0,0,0,0,0
0,0,0,0,0
0,0,0,0,0
0,0,0,0,0
0,0,0,0,0
0,0,0,0,0

n6
0,0,0,0,0
0,0,0,0,0
0,0,0,0,0
0,1,1,1,0
1,0,0,0,1
1,0,0,0,1
0,1,1,1,0

n7
1,1,1,1,1
0,0,0,1,0
0,0,0,1,0
0,0,1,0,0
0,0,1,0,0
0,1,0,0,0
0,1,0,0,0

n8
0,1,1,1,0
1,0,0,0,1
1,0,0,0,1
0,1,1,1,0
1,0,0,0,1
1,0,0,0,1
0,1,1,1,0

n9
0,1,1,1,0
1,0,0,0,1
1,0,0,0,1
0,1,1,1,1
0,0,0,0,1
0,0,0,0,1
0,1,1,1,0

n0
0,1,1,1,0
1,0,0,0,1
1,1,0,0,1
1,0,1,0,1
1,0,0,1,1
1,0,0,0,1
0,1,1,1,0